30 20
4
3 19
11 5
18 8
28 19
15 10
111000111000111000111000111000
100000000000000000000000000000
111110000000000000000000000011
111111110000000000000001111111
000000111000100000000000111111
000000111000110000000000000111
011000011111111100000000000011
011000000110000000000000000000
100000000000000000000000000000
111111111110000000000000000000
111111111000000000000000000000
100000000000000000000000000011
000000000000000000000000000000
000000000000011111111111111111
000000000000000000000000000000
000000000000000000000000000000
111111111111111000000000000000
100000000000000000000000001111
100000000000000001111111000001
100000000000000000000000000001