22 25
2
3 3
10 20
18 2
1111111111111111111111
1111000000000000000011
1100000000000000000111
1100000000011000000011
1000000000011000000001
1000000000111100000001
1001100001111110000001
1001100001111110000001
1001100001111110000001
1000000000011110000001
1000000001111110000001
1110000000011100000001
1110000000011000000001
1100000000000000000011
1100000000000000000011
1100000000000000000011
1110000000000000000111
1110000000000000000111
1110000000000000000111
1110000000011000000111
1110000000011000000111
1100000000000000000011
1100000000000000000011
1100000000000000000011
1111111111111111111111
