20 20
1
10 1
12 17
11000000000000000011
10001100000000110011
10001100001100110011
10001000000100010001
10001000000100000001
10001000000110000111
10000000000110000011
10000000000110000001
11000000000000000001
11000000000000000011
11000000000000000011
11100000000000000011
11000000011100000011
11000000011100000011
11000000011100000011
11000000011100000011
10000000000000000011
11110000000000111111
11110000000000111111
11111111111111111111

N is the robot
R is the rendezvous point