23 26
3
10 10
15 7
19 22
4 19
00000000000000000000000
10000000111111100000001
10000000111111110000001
10000000111111100000001
10000000111111100000001
11100000000000000000111
11100000000000000000111
11100000000000000000111
11100000000000000000111
11000000000000000000011
11000000000000000000011
10000000000100000000001
10000000000100000000001
10000000000100000000001
10000000001110000000001
10000000001110000000001
10000000000100000000001
10000000000100000000001
10000000000100000000001
11000000000000000000111
11000000000000000000111
11111100000000000000111
10000000000000000000001
10000000000000000000001
10000000000000000000001
10000000000000000000001